111111111101111111101111111000111111011111111111110111111111110111111111111110001111111111110111111
000110000110000110000110000110000110000110000110000110000110000110000110000110000110000110000110000
000110000110000110000110000110000110000110000110000110000110000110000110000110000110000110000110000
011000011000011000011000011000011000011000011000011000011000011000011000011000011000011000011000011
011300011300011300011300011300011300011300011300011300011300011300011300011300011300011300011300011
 00011000011000011000011000011000011000011000011000011000011000011000011000011000011000011000011000
 01100001100001100001100001100001100001100001100001100001100001100001100001100001100001100001100001
 01130001130001130001130001130001130001130001130001130001130001130001130001130001130001130001130001
 00001100001100001100001100001100001100001100001100001100001100001100001100001100001100001100001100
  0001100001100001100001100001100001100001100001100001100001100001100001100001100001100001100001100
  0110000110000110000110000110000110000110000110000110000110000110000110000110000110000110000110000
  0113000113000113000113000113000113000113000113000113000113000113000113000113000113000113000113000
  0000110000110000110000110000110000110000110000110000110000110000110000110000110000110000110000110
   000110000110000110000110000110000110000110000110000110000110000110000110000110000110000110000110
   011000011000011000011000011000011000011000011000011000011000011000011000011000011000011000011000
   011300011300011300011300011300011300011300011300011300011300011300011300011300011300011300011300
   000011000011000011000011000011000011000011000011000011000011000011000011000011000011000011000011
    00011000011000011000011000011000011000011000011000011000011000011000011000011000011000011000011
    01100001100001100001100001100001100001100001100001100001100001100001100001100001100001100001100
    01130001130001130001130001130001130001130001130001130001130001130001130001130001130001130001130
    00011000011000011000011000011000011000011000011000011000011000011000011000011000011000011000011
    00011000011000011000011000011000011000011000011000011000011000011000011000011000011000011000011
    01100001100001100001100001100001100001100001100001100001100001100001100001100001100001100001100
    01130001130001130001130001130001130001130001130001130001130001130001130001130001130001130001130
    00001100001100001100001100001100001100001100001100001100001100001100001100001100001100001100001
     0001100001100001100001100001100001100001100001100001100001100001100001100001100001100001100001
     0110000110000110000110000110000110000110000110000110000110000110000110000110000110000110000110
     0113000113000113000113000113000113000113000113000113000113000113000113000113000113000113000113
     0000110000110000110000110000110000110000110000110000110000110000110000110000110000110000110000
      000110000110000110000110000110000110000110000110000110000110000110000110000110000110000110000
      011000011000011000011000011000011000011000011000011000011000011000011000011000011000011000011
      011300011300011300011300011300011300011300011300011300011300011300011300011300011300011300011
      000000000000000000000000000000000000000000000000000000000000000000000000000000000000000000000
